"population	population
annotations	annotation
alignments	alignment
RNA-seq	rna-seq
align	alignment
bind binding
bed-file bed
metagenome	metagenomics
metagenomic metagenomics
metagenomicss metagenomics
sequencing; sequencing
bowtie2.0 bowtie2
citation	citations
class	classification
cluster	clustering
count	counts
cpus cpu
coordiante	coordinate
dynamic	dynamics
flags	flag
genbank-format genbank
-b/--breakdancer	breakdancer
chipseq	chip-seq
chip	chip-seq
careers career
p	p-valuep	p-value
annovar.	annovar
depthofcoverage depth
ds dssp
exon-skipping 	exon
linkage-disequilibrium	linkage
lineage-specific	lineage
ion	ion-torrent
htseqcount htseq
hic	hi-c
networks	network
nextgen	next-gen
next	next-gen
NGS	next-gen
ngs	next-gen
pathways	pathway
parameters	parameter
next-gen-sequencing	next-gen
next-generation-sequencing	next-gen
bamfiles	bam
bioninformatics	bioinformatics
bioinformation	bioinformatics
bioj	biojava
bl blast
chip_chicken	chip-seq
CNV	cnv
cnv-tagging	cnv
cnvseq	cnv
clusteringing	clustering
differential-expression	differential
enrichmentanalysis	enrichment
extract	extraction
expected_matrix	matrix
gccontent	gc
genetics"	genetics
gene-sequence	gene
getbamcounts	bam
gwa	gwas
indels	indel
introns	intron
k-mer	kmer
log	logarithmic
mutations	mutation
mutattion	mutation
negative_gilist	negative
newbie_question	newbie
open-ended	open
orthologue	ortholog
perl/python	perl
p-valueermutation	p-value
pubmedcentral	pubmed
psiblast	psi-blast
p-valuessm	p-value
p-valuewm	p-value
p-valueython	p-value
rep-valueeatmasker	repeatmasker
rep-valuelicates	replicates
secondarystructure	secondary
sequence-analysis	sequence
sequences	sequence
taxononomy	taxonomy
transcription_regulation_module	transcription
transcription_factor	transcription
workflows	workflow
whole	whole-genome
